{
  "rows": 21,
  "cols": 20,
  "layout": [
    "#####################",
    "#P...........K......#",
    "#.#####.#.#####.###.#",
    "#.#.....#.....#...#.#",
    "#.#.#########.#.#.#.#",
    "#.#.....K.....#.#.#.#",
    "#.###########.#.#.#.#",
    "#.....A.......#.#...#",
    "#####.#########.#.####",
    "#.....#.......#.#...#",
    "#.###.#.#####.#.#.#.#",
    "#.#...#.....#.#.#.#.#",
    "#.#.#########.#.#.#.#",
    "#.#.....K.....#.#.#.#",
    "#.###########.#.#.#.#",
    "#.....B.......#.#...#",
    "#####.######.##.#.####",
    "#.....#....K....#...#",
    "#.###.#.#####.#.#.#CE#",
    "#####################"
  ]
}
