{
  "board": [
    "####################",
    "#..................#",
    "#.######.####.#.##.#",
    "#.#....#.#..#......#",
    "#.#.##.#.#.#.#.###.#",
    "#...##.#...#.......#",
    "###.##.####.#.####.#",
    "#...#......#.....#.#",
    "#.#.#.####.#####.#.#",
    "#.#.#....#.........#",
    "#.#.####.#.#######.#",
    "#.#....#.#.........#",
    "#.######.#.#######.#",
    "#........#.......#.#",
    "#####.###.######.#.#",
    "#.........#......#.#",
    "#.#######.#.#####.#.#",
    "#...........#......#",
    "#.###########.####.#",
    "####################"
  ],

  "player_start": {
    "row": 1,
    "col": 1
  },

  "dragons": {
    "A": { "row": 7, "col": 3 },
    "B": { "row": 17, "col": 1 },
    "C": { "row": 15, "col": 3 }
  },

  "keys": [
    { "row": 1, "col": 8 },
    { "row": 7, "col": 12 },
    { "row": 13, "col": 3 },
    { "row": 17, "col": 8 }
  ],

  "exit": {
    "row": 9,
    "col": 10
  }
}
